┌───────────────────────────┬───────┬───────┬───────────────────┬───────────┬───────┐
│                           │       │       │                   │           │       │
│   ┌───────────┐   ┌───┐   ╵   ╷   └───┐   │   ┌───┬───╴   ╷   │   ╶───┬───┘   ╷   │
│   │           │   │   │       │       │   │   │   │       │   │       │       │   │
│   │   ┌───╴   ╵   │   └───────┼───╴   │   │   │   │   ┌───┤   │   ╷   ╵   ┌───┘   │
│   │   │           │           │       │   │   │   │   │   │   │   │       │       │
│   │   └───────┬───┘   ╶───┐   ╵   ┌───┘   │   │   │   │   │   └───┴───────┘   ╷   │
│   │           │           │       │       │   │   │   │   │                   │   │
│   ├───────┐   └───────────┤   ╶───┘   ┌───┘   │   │   │   └───────────┬───────┘   │
│   │       │               │           │       │   │   │               │           │
│   └───╴   ├───┬───────╴   ├───────────┤   ╶───┘   │   │   ╶───┬───────┘   ┌───────┤
│           │   │           │           │           │   │       │           │       │
├───────╴   │   │   ╶───────┤   ╶───┐   └───────╴   │   │   ╷   ╵   ┌───────┘   ╶───┤
│           │   │           │       │               │   │   │       │               │
│   ╶───────┘   └───┬───┐   ╵   ┌───┴───────────────┘   │   └───────┤   ┌───────┐   │
│                   │   │       │                       │           │   │       │   │
├───────────────╴   │   └───┬───┘   ┌───┬───────────────┴───────╴   ├───┘   ╷   │   │
│                   │       │       │   │                           │       │   │   │
│   ╶───┬───────┬───┘   ╷   │   ┌───┘   ╵   ╶───┬───────┐   ╶───┬───┘   ┌───┘   ╵   │
│       │       │       │   │   │               │       │       │       │           │
├───┐   │   ╶───┘   ┌───┘   │   │   ╶───────┬───┘   ╷   ├───┐   ╵   ┌───┴───┬───────┤
│   │   │           │       │   │           │       │   │   │       │       │       │
│   ╵   │   ╶───┬───┤   ┌───┘   │   ┌───────┤   ╶───┤   │   └───╴   │   ╷   ╵   ╷   │
│       │       │   │   │       │   │       │       │   │           │   │       │   │
│   ┌───┼───╴   │   │   │   ╶───┤   │   ╷   └───╴   │   └───┐   ╶───┤   └───┬───┘   │
│   │   │       │   │   │       │   │   │           │       │       │       │       │
│   │   ╵   ╶───┘   │   └───┐   └───┘   ├───────────┴───┐   ├───╴   │   ┌───┘   ┌───┤
│   │               │       │           │               │   │       │   │       │   │
│   │   ╶───┬───────┘   ╷   ├───────────┤   ┌───────╴   │   └───────┘   │   ┌───┘   │
│   │       │           │   │           │   │           │               │   │       │
│   └───┬───┘   ┌───────┤   └───┐   ╷   ╵   │   ┌───────┼───────────────┼───┘   ╷   │
│       │       │       │       │   │       │   │       │               │       │   │
├───┐   │   ╶───┤   ╶───┴───┐   │   ├───────┤   │   ╷   ╵   ╶───────┐   ╵   ╷   │   │
│   │   │       │           │   │   │       │   │   │               │       │   │   │
│   │   │   ╷   │   ╶───┐   ╵   │   └───╴   │   │   ├───────────────┤   ╶───┤   │   │
│   │   │   │   │       │       │           │   │   │               │       │   │   │
│   │   ├───┘   ├───╴   ├───────┴───┬───────┤   ╵   │   ╶───────┐   └───────┤   └───┤
│   │   │       │       │           │       │       │           │           │       │
│   │   │   ┌───┤   ┌───┴───╴   ╷   │   ╷   ├───────┴───┐   ╷   ├───────┐   └───┐   │
│   │   │   │   │   │           │   │   │   │           │   │   │       │       │   │
│   ╵   ╵   │   ╵   └───╴   ┌───┘   ╵   │   ╵   ┌───╴   └───┘   │   ╶───┴───╴   ╵   │
│           │               │           │       │               │                   │
└───────────┴───────────────┴───────────┴───────┴───────────────┴───────────────────┘