┌───────────────┬───────────────────┬───────────────────────────┬───────────────────┐│               │                   │                           │                   │
│   ╶───────┐   │   ┌───────────╴   │   ┌───────────────┬───╴   │   ┌───────────┐   ││           │   │   │               │   │               │       │   │           │   │
│   ╶───┐   └───┘   ├───────────────┘   │   ┌───────┐   │   ╶───┤   ╵   ╶───┐   └───┤
│       │           │                   │   │       │   │       │           │       │
├───┐   ├───────────┘   ┌───────────┬───┘   ╵   ╷   │   └───╴   ├───────────┴───┐   │
│   │   │               │           │           │   │           │               │   │
│   ╵   │   ┌───────────┤   ╶───┐   └───────┐   ├───┴───────┐   │   ╶───────┐   ╵   │
│       │   │           │       │           │   │           │   │           │       │
│   ╶───┤   ╵   ╶───┐   ├───╴   ├───────┐   ├───┘   ╶───┐   │   └───────╴   ├───┐   │
│       │           │   │       │       │   │           │   │               │   │   │
├───┐   └───┬───────┤   │   ┌───┘   ╷   │   ╵   ┌───────┤   ├───────────────┤   ╵   │
│   │       │       │   │   │       │   │       │       │   │               │       │
│   └───┐   │   ╷   │   │   └───────┤   └───┬───┘   ╷   ╵   │   ╶───┐   ┌───┘   ┌───┤
│       │   │   │   │   │           │       │       │       │       │   │       │   │
│   ╷   │   ╵   │   │   └───────╴   ├───╴   │   ╷   ├───────┼───────┤   ╵   ┌───┘   │
│   │   │       │   │               │       │   │   │       │       │       │       │
│   │   └───────┤   │   ╶───────────┤   ╶───┤   └───┘   ╷   ╵   ╷   │   ╶───┼───╴   │
│   │           │   │               │       │           │       │   │       │       │
├───┴───┐   ╷   │   └───────┬───╴   │   ╷   └───┬───────┴───────┘   ├───╴   ╵   ╷   │
│       │   │   │           │       │   │       │                   │           │   │
│   ╷   └───┘   └───┬───╴   │   ┌───┘   ├───╴   │   ╶───────────┬───┴───┬───────┴───┤
│   │               │       │   │       │       │               │       │           │
│   └───────────┬───┘   ┌───┤   │   ╶───┤   ╶───┴───────────┐   │   ╷   │   ╶───┐   │
│               │       │   │   │       │                   │   │   │   │       │   │
├───────┬───╴   │   ┌───┘   ╵   └───────┴───┐   ╶───┐   ╷   │   ╵   │   └───┐   │   │
│       │       │   │                       │       │   │   │       │       │   │   │
│   ╷   ╵   ╷   │   ├───────────────────┐   ├───╴   │   │   ├───────┤   ┌───┘   │   │
│   │       │   │   │                   │   │       │   │   │       │   │       │   │
│   ├───╴   ├───┘   │   ┌───┬───────╴   │   └───┐   │   │   │   ╷   ╵   │   ┌───┘   │
│   │       │       │   │   │           │       │   │   │   │   │       │   │       │
│   │   ╶───┤   ┌───┘   │   │   ┌───────┴───╴   │   │   │   │   └───┬───┘   │   ╷   │
│   │       │   │       │   │   │               │   │   │   │       │       │   │   │
│   ├───╴   │   ├───╴   │   ╵   │   ┌───────┐   └───┘   │   ├───┐   │   ┌───┤   └───┤
│   │       │   │       │       │   │       │           │   │   │   │   │   │       │
│   │   ╶───┤   │   ╶───┴───┐   │   │   ╷   ├───────┬───┤   │   │   ╵   ╵   └───┐   │
│   │       │   │           │   │   │   │   │       │   │   │   │               │   │
│   ├───────┤   └───┬───╴   │   └───┤   │   │   ╷   │   ╵   ╵   └───────┬───────┘   │
│   │       │       │       │       │   │   │   │   │                   │           │
│   ╵   ╷   └───╴   ╵   ┌───┴───╴   ╵   │   ╵   │   └───────────────────┘   ┌───╴   │
│       │               │               │       │                           │       │
└───────┴───────────────┴───────────────┴───────┴───────────────────────────┴───────┘